{
    "0": 0,
    "1": 1,
    "2": 2,
    "3": 3,
    "4": 4,
    "5": 5,
    "6": 6,
    "7": 7,
    "8": 8,
    "9": 9,
    "10": 10,
    "11": 11,
    "12": 12,
    "13": 13,
    "14": 14,
    "15": 15,
    "16": 16,
    "17": 17,
    "18": 18,
    "19": 18,
    "20": 19,
    "21": 20,
    "22": 21,
    "23": 22,
    "24": 23,
    "25": 24,
    "26": 25,
    "27": 26,
    "28": 27,
    "29": 28,
    "30": 28,
    "31": 29,
    "32": 30,
    "33": 31,
    "34": 32,
    "35": 33,
    "36": 34,
    "37": 34,
    "38": 35,
    "39": 36,
    "40": 37,
    "41": 37,
    "42": 38,
    "43": 39,
    "44": 40,
    "45": 42,
    "46": 44,
    "47": 46,
    "48": 39,
    "49": 47,
    "50": 48,
    "51": 49,
    "52": 50,
    "53": 51,
    "54": 52,
    "55": 53,
    "56": 44,
    "57": 54,
    "58": 55,
    "59": 56,
    "60": 57,
    "61": 58,
    "62": 59,
    "63": 60,
    "64": 41,
    "65": 61,
    "66": 57,
    "67": 45,
    "68": 62,
    "69": 63,
    "70": 36,
    "71": 64,
    "72": 65,
    "73": 66,
    "74": 67,
    "75": 68,
    "76": 69,
    "77": 70,
    "78": 59,
    "79": 71,
    "80": 72,
    "81": 62,
    "82": 73,
    "83": 74,
    "84": 75,
    "85": 76,
    "86": 61,
    "87": 77,
    "88": 78,
    "89": 79,
    "90": 80,
    "91": 43,
    "92": 81,
    "93": 82,
    "94": 83,
    "95": 84,
    "96": 85,
    "97": 86,
    "98": 87,
    "99": 88
}